00000000
00000000
00000000
00000000
000#0000
00#0#000
00#0#000
00#0#000
00#1#000
000#3000