00000000
00000000
00000000
00000000
00000000
00000000
00000000
00000000
########
11111111