11111111
12222221
12333321
12344321
123##321
123##321
12344321
12333321
12222221
11111111